11111111111111111111111111111111
11101001000000000010000000010001
11000011011101111011101111011101
10011001010100001000101010000000
10111101110111101110100011111101
10000100000000000000111100000101
11110001110001111100000001000101
10110011010100010001101101011101
10000111000100011111100001000001
10110101110111010000001111010111
10000100000000010110101000010111
10111101111101011100101011110001
11100000010100000000101011011101
10011000110101011110101001000101
11000010010001010000101101011101
11101010010111010111111101000001
11101011000100010000000001111101
11000010011111110111011101000101
11011111110101000101010111110101
11010000000001111101010000010101
11010100111101000000010111010001
10000100100001110111110101000101
11101101110000010100000101111101
11000000000111110111011100000001
11011101010001000001010001111101
10000111011111111101011100001001
11010001110000000001000101011101
11010111011011111010101101010001
00010100001010001010101101110101
11110111101110100010100110110111
10000000000000111110001000000001
11111111111111111111111111111111
