11111111111111111111111111111111
10000110000001000010000000010001
11110011010101111011101111011101
10001001010100001000101010000000
10111101110111101110100011111101
10000100000100000000111100000101
11110001110101111101100001000101
10110011010100010001101101011101
10000111000100011101100001000001
10110101110111010000001111010111
10000100000000010110101010010001
10111111111101011000100010111101
11100010110100000011101010011101
10011010100101011110001001000001
11000010110001010010101101111101
11101000010111010110111101000001
11101011000100010000010001111101
11000010011111110111011101000101
11010111110101000101010111110101
11010100000001011101010000010101
11010100111101110000010111010001
10000100100001000111110101000101
11101101110000011100000101111101
11000000000111110111011100000001
11011101010001000001010001111101
11010111011111111101011100001001
11010001110000000001000101011101
11000111011011111010101101010001
00010100001010001010101101110101
11110111101110100010100010110111
10000010000000111110001000000001
11111111111111111111111111111111
