11111111111111111111111111111111
10000010000001000000000000000001
11110011111101111011101111011101
10001000100100001000101010000100
10110111110111101110100011111101
10010100000100000000111100000001
11100001110101100111100001000101
10111011010000011001001111011101
10000110000111010101100001000001
10110101110101010000001111010111
10000100000000010110101010010001
10110111101101011000101010111101
11100010110100000011101011100101
10011010100101011110001001000001
11000010110001010010101101101101
11101000010111000110111100000001
11101011000100010000010001101101
11000010011111110111011101000101
11010111110101000101010111110101
11010100000001011101010000010101
11111000111101110000010111010001
10001100100001000111110101000101
11101001110100011100000101111101
11000001000111110111011100000001
11011101010001000001010001111101
11010111011111111101011100001001
11010000010000000001000101011101
11000111111011111010101101010001
00010100001010001010101101110101
11110111101110100010100010110111
10000010000000111110001000000001
11111111111111111111111111111111
