11111111111111111111111111111111
10100000100010001000100000010001
10101110001011101110111011110001
10111010111000100000001010010000
10001000000010111011011000110001
11101011101010101001000010010001
10100010101110101101111111110001
10111010100010100000100010010001
10000010011110110110101000110001
11011011010000010000001110010001
11000000010111011110111011010001
11111101110101000010100000010001
10000001011100010110101111010001
10111101001001010000001000010001
10001001101101111101111011110001
11101100100001000001000010010001
10001110111101010111011011010001
10111000000001010001010110010001
10001011110111011101010011010001
10011010010001000100011001010001
11010011011101110101000100010001
10010001000001000101110101010001
10110101110101010100000001110001
10100100010111110001111111010001
10110101010000000111000100010001
10100011010111110000010110110001
10101010000000100110010000010001
11111111111111111111111111110001
00000000000000000000000000000001
10000000000000000000000000000001
10000000000000000000000000000001
11111111111111111111111111111111
